###                 #########
#   ###################   # #
# ####                # # # #
# ################### # # # #
#                     # # # #
##################### # # # #
#   ##                # # # #
# # ## ### ############ # # #
# #    #   ##B          # # #
# # ## ###### ######### # # #
### ##             #### # # #
### ######### #### ## # # # #
###             ##    # # # #
###### ######## ####### # # #
######                  #   #
A      ######################
